/---+---+---+---+---+---+---\
|             A         |   |
+   +   +---+   +---+   +---+
|                   |       |
+   +   +   +---+   +   +   +
|   |       |               |
+   +   +---+   +---+---+   +
| a     |               | b |
+   +   +   +   +---+   +   +
|   |       |   |           |
+   +---+   +   +   +---+   +
|           |       |       |
+---+   +   +---+   +   +   +
|   |         B             |
\---+---+---+---+---+---+---/