/---+---+---+---+---+---+---\
|       |     A     |       |
+   +---+   +---+   +---+   +
|   |       |           |   |
+---+   +   +   +---+   +---+
|                           |
+   +---+   +   +   +---+   +
|   |           |           |
+   +   +   +---+   +   +---+
|       |           |       |
+---+   +   +   +---+   +---+
|   |       |           |   |
+   +---+   +   +   +---+   +
|       |     B |   |       |
\---+---+---+---+---+---+---/